--------
----WWWW
--WWW--W
WWW---PW
WF--BW-W
WFFB-B-W
WWWF-B-W
--WWW--W
----WWWW