----WWWWW
WWWWW-P-W
W--WWBB-W
W-----B-W
W---WWWWW
WWW-W----
-W--WWW--
-W-FFFW--
-WWWWWW--