---WWWWW
---WP--W
---W-W-W
---W---W
---WBW-W
---W---W
WWWWBW-W
WFFF---W
W-WWBWWW
W----W--
WWWWWW--