WWWWW---
W---WWWW
W-B-W--W
W---B-PW
WWWW--FW
-W-B-WFW
-W-W-WFW
-W---WWW
-WWWWW--