---------
-WWWWWWWW
-WFWF-B-W
WWPWWW--W
W-B-W---W
W--BBFBFW
W--F--B-W
WWWWWWF-W
-----WWWW