--------
-WWWWWWW
WW-WWFFW
W-PB-BFW
W-B-B--W
WWWW--FW
---WWWWW
--------