---------
---WWW---
---WFW---
WWWW-W---
WF-BBWWW-
WWW-PBFW-
--WBWWWW-
--WFW----
--WWW----